+---+---+---+---+---+---+---+---+---+---+---+---+---+---+---+---+---+---+---+---+---+---+---+---+---+---+---+---+---+---+---+---+
|   |                                               |                                   |                                       |
+   +   +---+---+---+---+---+---+---+---+---+   +   +---+   +---+---+   +---+---+   +   +---+---+---+---+---+---+---+---+   +   +
|       |                                   |   |       |                   |       |                     G             |   |   |
+   +---+   +---+---+---+---+---+   +   +---+   +---+   +---+   +---+   +---+   +---+---+---+---+---+---+---+---+---+   +---+   +
|   |                               |   |       |   |       |                   |                           |       |           |
+   +   +---+---+---+---+---+---+---+   +   +---+   +---+   +---+---+   +   +---+---+   +---+---+---+---+   +---+   +---+---+   +
|   |   |                           |   |   |           |       |       |   |           |               |       |       |       |
+   +   +   +---+   +---+---+---+   +   +   +   +---+---+---+   +---+   +   +---+   +---+   +---+---+   +---+   +   +---+   +   +
|   |   |       |   |               |   |   |               |       |   |   |       |                       |       |       |   |
+   +   +   +---+   +---+---+---+---+   +   +---+   +---+   +---+   +---+   +   +---+   +---+---+---+---+   +---+   +   +---+   +
|   |   |   |       |                   |       |       |       |       |   |                                   |   |           |
+   +   +   +   +---+   +---+---+---+   +---+   +---+   +---+   +---+   +   +   +---+---+   +   +---+---+---+   +   +   +---+   +
|   |   |   |   |                       |   |       |               |   |   |   |       |   |               |   |   |       |   |
+   +   +   +   +   +---+   +   +   +   +   +---+   +---+---+---+   +   +   +   +   +   +---+   +---+   +---+   +   +---+   +   +
|   |   |   |   |       |   |   |   |   |       |   |           |       |   |       |       |       |   |       |   |   |       |
+   +   +---+   +---+   +---+   +   +   +---+   +   +   +---+   +---+   +   +   +---+---+   +---+   +   +   +---+   +   +---+   +
|   |       |       |       |   |               |       |   |       |       |       |       |       |   |   |   |   |       |   |
+   +---+   +---+   +---+   +   +   +---+---+---+---+   +   +---+   +---+---+---+---+   +---+   +---+   +   +   +   +   +   +   +
|   |   |               |   |       |               |       |   |   |                   |                       |   |   |   |   |
+   +   +---+---+   +---+   +   +---+   +---+---+   +---+   +   +   +   +---+   +---+---+   +   +---+---+---+---+   +---+   +   +
|   |           |   |       |   |       |       |       |       |   |   |       |           |                       |       |   |
+   +   +   +   +   +   +   +---+   +---+   +   +---+   +---+   +   +---+   +   +---+---+   +---+---+---+---+---+---+   +---+   +
|   |   |   |   |   |   |   |       |       |       |   |   |   |   |       |   |       |                               |       |
+   +   +   +   +   +   +   +   +---+   +---+---+   +   +   +   +   +   +   +---+   +   +   +---+---+---+---+---+   +---+   +---+
|   |       |   |   |   |       |       |           |           |   |   |   |       |       |                       |       |   |
+   +   +   +   +   +   +   +   +   +---+---+---+---+   +---+---+   +   +   +   +---+---+   +---+---+   +---+---+   +   +---+   +
|   |   |   |   |   |   |   |   |                       |           |   |       |       |           |                   |       |
+   +   +   +   +   +   +   +   +   +---+---+---+---+---+   +---+---+   +   +---+   +   +---+---+   +---+---+---+   +---+---+   +
|   |       |   |   |   |   |   |   |           |           |       |       |       |           |                               |
+   +---+   +   +   +   +   +   +   +   +---+---+   +   +---+   +---+   +---+   +---+---+---+   +---+---+---+---+---+---+   +   +
|       |   |       |   |   |   |           |       |                           |           |               |               |   |
+---+   +---+---+---+   +   +   +   +---+   +   +   +---+   +---+   +---+---+   +   +---+---+---+---+---+   +---+---+   +---+   +
|   |                   |   |   |       |       |               |               |                                       |   |   |
+   +---+---+---+---+   +   +   +---+   +   +---+   +---+---+   +---+---+---+---+---+---+---+---+   +---+---+---+---+---+   +   +
|                   |   |   |           |   |               |           |                       |                           |   |
+   +---+---+---+   +   +   +   +---+---+   +   +---+---+   +---+---+   +   +---+---+---+---+   +---+---+---+---+---+---+   +   +
|   |           |   |   |   |           |   |   |       |           |   |   |                                                   |
+   +---+---+   +   +   +   +   +   +   +   +   +   +   +---+   +---+   +   +   +---+---+   +---+---+---+---+---+   +---+---+   +
|       |       |       |   |   |   |   |   |   |   |               |   |   |   |           |   |                   |           |
+   +   +   +---+---+---+   +   +---+   +   +   +   +---+   +---+   +   +   +   +   +---+---+   +   +---+   +---+---+   +---+---+
|   |       |               |   |       |   |   |   |               |   |   |                   |       |       |               |
+   +   +---+   +---+---+---+   +   +   +   +   +   +---+---+   +   +   +   +---+---+---+---+---+   +---+---+   +   +---+   +   +
|       |       |           |   |   |   |   |   |       |       |   |   |                           |           |       |   |   |
+---+   +   +---+   +---+   +   +   +   +   +   +---+   +---+   +   +   +---+---+---+---+---+---+   +   +---+   +---+   +---+   +
|           |   |   |   |       |   |   |   |       |       |   |   |   |                       |   |   |   |   |   |       |   |
+   +---+---+   +   +   +---+---+   +---+   +---+   +   +   +   +   +   +   +---+---+---+---+   +---+   +   +   +   +---+   +   +
|                               |       |   |   |   |   |   |   |   |       |               |       |   |   |   |       |       |
+   +   +   +   +---+---+---+   +---+   +   +   +   +   +   +   +   +---+---+---+   +---+   +---+   +   +   +   +   +   +---+   +
|   |   |   |       |       |       |       |           |   |   |               |       |       |   |   |   |   |   |           |
+   +---+   +---+   +---+   +---+   +---+   +---+---+   +   +---+   +---+   +   +---+   +---+   +   +   +   +   +   +   +---+   +
|   |       |       |           |       |               |       |           |       |       |   |   |   |   |   |   |   |       |
+   +   +---+   +---+   +---+   +---+   +---+   +---+   +---+   +   +   +   +   +   +---+   +---+   +   +   +   +   +---+   +   +
|   |   |               |   |       |       |       |       |   |   |   |       |       |       |   |   |   |   |   |       |   |
+   +   +---+---+---+---+   +---+   +---+   +---+   +---+   +   +   +   +---+   +---+   +---+   +   +   +   +   +   +   +---+   +
|   |               |                   |   |   |       |       |   |                       |   |   |   |           |   |       |
+   +   +---+   +   +---+   +---+---+   +   +   +---+   +---+   +   +   +---+---+   +---+   +   +   +   +---+---+   +   +   +   +
|   |   |       |       |           |   |   |               |   |   |   |               |       |   |       |       |   |   |   |
+   +   +   +   +---+   +---+   +---+   +   +---+---+---+   +---+   +   +---+---+---+---+---+   +   +   +   +   +---+   +   +   +
|   |   |   |       |       |           |               |       |   |                           |   |   |   |       |   |   |   |
+   +   +---+   +   +   +   +---+   +---+---+---+---+   +---+   +   +   +---+---+---+---+---+---+   +   +   +---+   +   +   +   +
|   |       |   |       |       |               |                   |       |                       |   |       |   |   |   |   |
+   +---+   +   +---+   +---+   +---+---+---+---+   +---+---+---+---+---+---+   +---+---+---+---+---+   +---+   +---+   +---+   +
| S |                       |                                                                               |                   |
+---+---+---+---+---+---+---+---+---+---+---+---+---+---+---+---+---+---+---+---+---+---+---+---+---+---+---+---+---+---+---+---+
